BETE

super == ènèni
autre(certain,prochain) == vinin
bizarre == ècossabrou
difficile(grave,fort) == ètèmin
drole == èléglaco
facile == némétin
impossible == ???
jeune == woody_oh_digba
juste == èkokpéé
malade == angou
pauvre == pouè
possible == èbèlé
propre == (hénènouko)?
rouge == zèlé
sale == fé
simple == ècofouho
tranquille == vrihé
triste == gninzé
vide == couho
bonne == nèni
toute == cléclé
doux == mèni
faux == yio
francais == gomlan_gbo
heureux (content) == ouannan
mauvais == gningni
serieux == okotéé
vieux == gognon
vrai == diè
ancien == gogo
beau == bagnon
blanc == fah
chaud == ???
cher == ètèpriko
dernier == bémin
different == èniblémin
droit == gbihi
entier == èwaniclo
froid == wotro
gentille == oninnnidréko
grand == yité
haut == ètroko
humain == gnekpa
jolie == ènèni *
leger == foco
long == ètromi
meilleur == èziko
nouveau == lélé
pareil(meme) == mlé
petit == tékéhi
plein == èyihé
premier == youcou
quoi == tèkoi
seul == gboro
vivant == oyè
aide == okpèlio
chef == fi
enfant == you
garde == ???
gauche == okpè
geste == zigbo
livre == borgo*
merci == yawouo
ombre == zouzou
part == homédè
poche == poché
professeur == souk(r)oumassi*
madame == monni_wonnon
paix == waléwaliè
voix == wèlé
affaire == gbo
arme == kossougou
armée == srodja
attention == manamin
boite == clokoua
bouche == mouha